F 71,135,87
C 127,224,224
NO ./png/red_tex.png
SO ./png/green_tex.png
WE ./png/yellow_tex.png
EA ./png/blue_tex.png


        1111111111111111111111111
        10000000001100000000000011
        100110000011100000000000011
        10010000000000000000000011
111111111011000001110000000000001
100000000011000001110111110111111
11110111111111011100000010001
11110111111111011101010010001
11000000110101011100000000001N
10000000000000001100000010001
10000010000000001101010010001
1100000111010101111101111000111
11111111 1110101 101111010001
11111111 1111111 111111111111